graphics/back.bmp 1

1
data/block1.txt

71

0 255 255 255 255 412 60 32 16
0 255 255 255 255 380 60 32 16
0 255 255 255 255 348 60 32 16
0 255 255 255 255 316 60 32 16
0 255 255 255 255 284 60 32 16
0 255 255 255 255 252 60 32 16
0 255 255 255 255 220 60 32 16

0 255 255 255 255 444 76 32 16
0 180 255 37 180 412 76 32 16
0 180 255 37 180 380 76 32 16
0 180 255 37 180 348 76 32 16
0 180 255 37 180 316 76 32 16
0 180 255 37 180 284 76 32 16
0 180 255 37 180 252 76 32 16
0 180 255 37 180 220 76 32 16
0 255 255 255 255 188 76 32 16

0 255 255 255 255 412 92 32 16
0 255 255 255 255 380 92 32 16
0 255 255 255 255 348 92 32 16
0 255 255 255 255 316 92 32 16
0 255 255 255 255 284 92 32 16
0 255 255 255 255 252 92 32 16
0 255 255 255 255 220 92 32 16

0 255 255 255 255 444 108 32 16
0 180 255 37 180 412 108 32 16
0 180 255 37 180 380 108 32 16
0 180 255 37 180 348 108 32 16
0 180 255 37 180 316 108 32 16
0 180 255 37 180 284 108 32 16
0 180 255 37 180 252 108 32 16
0 180 255 37 180 220 108 32 16
0 255 255 255 255 188 108 32 16

0 255 255 255 255 412 124 32 16
0 255 255 255 255 380 124 32 16
0 255 255 255 255 348 124 32 16
0 255 255 255 255 316 124 32 16
0 255 255 255 255 284 124 32 16
0 255 255 255 255 252 124 32 16
0 255 255 255 255 220 124 32 16

0 255 255 255 255 444 140 32 16
0 180 255 37 180 412 140 32 16
0 180 255 37 180 380 140 32 16
0 180 255 37 180 348 140 32 16
0 180 255 37 180 316 140 32 16
0 180 255 37 180 284 140 32 16
0 180 255 37 180 252 140 32 16
0 180 255 37 180 220 140 32 16
0 255 255 255 255 188 140 32 16

0 255 255 255 255 412 156 32 16
0 255 255 255 255 380 156 32 16
0 255 255 255 255 348 156 32 16
0 255 255 255 255 316 156 32 16
0 255 255 255 255 284 156 32 16
0 255 255 255 255 252 156 32 16
0 255 255 255 255 220 156 32 16

0 255 255 255 255 444 172 32 16
0 180 255 37 180 412 172 32 16
0 180 255 37 180 380 172 32 16
0 180 255 37 180 348 172 32 16
0 180 255 37 180 316 172 32 16
0 180 255 37 180 284 172 32 16
0 180 255 37 180 252 172 32 16
0 180 255 37 180 220 172 32 16
0 255 255 255 255 188 172 32 16

0 255 255 255 255 412 188 32 16
0 255 255 255 255 380 188 32 16
0 255 255 255 255 348 188 32 16
0 255 255 255 255 316 188 32 16
0 255 255 255 255 284 188 32 16
0 255 255 255 255 252 188 32 16
0 255 255 255 255 220 188 32 16