graphics/back.bmp 1

1
data/block1.txt

144

0 255 255 255 255 44 60 32 16
0 255 255 255 255 76 60 32 16
0 255 255 255 255 108 60 32 16
0 255 255 255 255 140 60 32 16
0 255 255 255 255 172 60 32 16
0 255 255 255 255 204 60 32 16
0 255 255 255 255 236 60 32 16
0 255 255 255 255 268 60 32 16
0 255 255 255 255 300 60 32 16
0 255 255 255 255 332 60 32 16
0 255 255 255 255 364 60 32 16
0 255 255 255 255 396 60 32 16
0 255 255 255 255 428 60 32 16
0 255 255 255 255 460 60 32 16
0 255 255 255 255 492 60 32 16
0 255 255 255 255 524 60 32 16
0 255 255 255 255 556 60 32 16
0 255 255 255 255 588 60 32 16


0 255 255 255 255 44 76 32 16
0 255 255 255 255 76 76 32 16
0 255 255 255 255 108 76 32 16
0 255 255 255 255 140 76 32 16
0 255 255 255 255 172 76 32 16
0 255 255 255 255 204 76 32 16
0 255 255 255 255 236 76 32 16
0 255 255 255 255 268 76 32 16
0 255 255 255 255 300 76 32 16
0 255 255 255 255 332 76 32 16
0 255 255 255 255 364 76 32 16
0 255 255 255 255 396 76 32 16
0 255 255 255 255 428 76 32 16
0 255 255 255 255 460 76 32 16
0 255 255 255 255 492 76 32 16
0 255 255 255 255 524 76 32 16
0 255 255 255 255 556 76 32 16
0 255 255 255 255 588 76 32 16

0 255 255 255 255 44 92 32 16
0 255 255 255 255 76 92 32 16
0 255 255 255 255 108 92 32 16
0 255 255 255 255 140 92 32 16
0 255 255 255 255 172 92 32 16
0 255 255 255 255 204 92 32 16
0 255 255 255 255 236 92 32 16
0 255 255 255 255 268 92 32 16
0 255 255 255 255 300 92 32 16
0 255 255 255 255 332 92 32 16
0 255 255 255 255 364 92 32 16
0 255 255 255 255 396 92 32 16
0 255 255 255 255 428 92 32 16
0 255 255 255 255 460 92 32 16
0 255 255 255 255 492 92 32 16
0 255 255 255 255 524 92 32 16
0 255 255 255 255 556 92 32 16
0 255 255 255 255 588 92 32 16

0 255 255 255 255 44 108 32 16
0 255 255 255 255 76 108 32 16
0 255 255 255 255 108 108 32 16
0 255 255 255 255 140 108 32 16
0 255 255 255 255 172 108 32 16
0 255 255 255 255 204 108 32 16
0 255 255 255 255 236 108 32 16
0 255 255 255 255 268 108 32 16
0 255 255 255 255 300 108 32 16
0 255 255 255 255 332 108 32 16
0 255 255 255 255 364 108 32 16
0 255 255 255 255 396 108 32 16
0 255 255 255 255 428 108 32 16
0 255 255 255 255 460 108 32 16
0 255 255 255 255 492 108 32 16
0 255 255 255 255 524 108 32 16
0 255 255 255 255 556 108 32 16
0 255 255 255 255 588 108 32 16

0 255 255 255 255 44 124 32 16
0 255 255 255 255 76 124 32 16
0 255 255 255 255 108 124 32 16
0 255 255 255 255 140 124 32 16
0 255 255 255 255 172 124 32 16
0 255 255 255 255 204 124 32 16
0 255 255 255 255 236 124 32 16
0 255 255 255 255 268 124 32 16
0 255 255 255 255 300 124 32 16
0 255 255 255 255 332 124 32 16
0 255 255 255 255 364 124 32 16
0 255 255 255 255 396 124 32 16
0 255 255 255 255 428 124 32 16
0 255 255 255 255 460 124 32 16
0 255 255 255 255 492 124 32 16
0 255 255 255 255 524 124 32 16
0 255 255 255 255 556 124 32 16
0 255 255 255 255 588 124 32 16


0 255 255 255 255 44 140 32 16
0 255 255 255 255 76 140 32 16
0 255 255 255 255 108 140 32 16
0 255 255 255 255 140 140 32 16
0 255 255 255 255 172 140 32 16
0 255 255 255 255 204 140 32 16
0 255 255 255 255 236 140 32 16
0 255 255 255 255 268 140 32 16
0 255 255 255 255 300 140 32 16
0 255 255 255 255 332 140 32 16
0 255 255 255 255 364 140 32 16
0 255 255 255 255 396 140 32 16
0 255 255 255 255 428 140 32 16
0 255 255 255 255 460 140 32 16
0 255 255 255 255 492 140 32 16
0 255 255 255 255 524 140 32 16
0 255 255 255 255 556 140 32 16
0 255 255 255 255 588 140 32 16

0 255 255 255 255 44 156 32 16
0 255 255 255 255 76 156 32 16
0 255 255 255 255 108 156 32 16
0 255 255 255 255 140 156 32 16
0 255 255 255 255 172 156 32 16
0 255 255 255 255 204 156 32 16
0 255 255 255 255 236 156 32 16
0 255 255 255 255 268 156 32 16
0 255 255 255 255 300 156 32 16
0 255 255 255 255 332 156 32 16
0 255 255 255 255 364 156 32 16
0 255 255 255 255 396 156 32 16
0 255 255 255 255 428 156 32 16
0 255 255 255 255 460 156 32 16
0 255 255 255 255 492 156 32 16
0 255 255 255 255 524 156 32 16
0 255 255 255 255 556 156 32 16
0 255 255 255 255 588 156 32 16

0 255 255 255 255 44 172 32 16
0 255 255 255 255 76 172 32 16
0 255 255 255 255 108 172 32 16
0 255 255 255 255 140 172 32 16
0 255 255 255 255 172 172 32 16
0 255 255 255 255 204 172 32 16
0 255 255 255 255 236 172 32 16
0 255 255 255 255 268 172 32 16
0 255 255 255 255 300 172 32 16
0 255 255 255 255 332 172 32 16
0 255 255 255 255 364 172 32 16
0 255 255 255 255 396 172 32 16
0 255 255 255 255 428 172 32 16
0 255 255 255 255 460 172 32 16
0 255 255 255 255 492 172 32 16
0 255 255 255 255 524 172 32 16
0 255 255 255 255 556 172 32 16
0 255 255 255 255 588 172 32 16
