graphics/back.bmp 1

1
data/block1.txt

48

0 255 255 255 255 44 60 32 16
0 255 255 255 255 76 60 32 16
0 255 255 255 255 108 60 32 16
0 255 255 255 255 140 60 32 16
0 255 255 255 255 172 60 32 16
0 255 255 255 255 204 60 32 16
0 255 255 255 255 236 60 32 16
0 255 255 255 255 268 60 32 16
0 255 255 255 255 300 60 32 16
0 255 255 255 255 332 60 32 16
0 255 255 255 255 364 60 32 16
0 255 255 255 255 396 60 32 16
0 255 255 255 255 428 60 32 16
0 255 255 255 255 460 60 32 16
0 255 255 255 255 492 60 32 16
0 255 255 255 255 524 60 32 16
0 255 255 255 255 556 60 32 16
0 255 255 255 255 588 60 32 16


0 255 255 255 255 44 76 32 16
0 255 255 255 255 588 76 32 16

0 255 255 255 255 44 92 32 16
0 255 255 255 255 588 92 32 16

0 255 255 255 255 44 108 32 16
0 255 255 255 255 588 108 32 16

0 255 255 255 255 44 124 32 16
0 255 255 255 255 588 124 32 16


0 255 255 255 255 44 140 32 16
0 255 255 255 255 588 140 32 16

0 255 255 255 255 44 156 32 16
0 255 255 255 255 588 156 32 16

0 255 255 255 255 44 172 32 16
0 255 255 255 255 76 172 32 16
0 255 255 255 255 108 172 32 16
0 255 255 255 255 140 172 32 16
0 255 255 255 255 172 172 32 16
0 255 255 255 255 204 172 32 16
0 255 255 255 255 236 172 32 16
0 255 255 255 255 268 172 32 16
0 255 255 255 255 300 172 32 16
0 255 255 255 255 332 172 32 16
0 255 255 255 255 364 172 32 16
0 255 255 255 255 396 172 32 16
0 255 255 255 255 428 172 32 16
0 255 255 255 255 460 172 32 16
0 255 255 255 255 492 172 32 16
0 255 255 255 255 524 172 32 16
0 255 255 255 255 556 172 32 16
0 255 255 255 255 588 172 32 16
